X0000000X00
0X000000X00
00X00000X00
000X0000X00	
0000X000X00
00000X00X00
000000XXX00
0000000XXXX
XXXXXXXXXXX
0000000XXXX
0000000XXXX